....................
....................
....................
....................
....................
....................
....................
.........GGG........
.........###........
....................
....GGG.......GXG...
....###.......###...
....................
...............1....
####################
