....................
....................
....................
##########..........
#...................
#...................
#...................
#........GGG........
#........###........
#...................
#...GGG.......GXG...
#...###.......###...
#...................
#1...A.............
####################
